7 10
**********
*   * *  *
E        *
*   *    *
* * * ** *
* * *  * S
**********
